NO assets/images/wood.xpm
SO assets/images/redbrick.xpm
WE assets/images/bluestone.xpm
EA assets/images/greystone.xpm
F 127,127,127
C 135,206,250

      1111111111111111111111111
      1000000000110000000000001
      1011000001110000000000001
      100100000000000S0000000011111111
111111111011000001100000000000001
100000000011000001110000011111111
10110111111111011100000010001
10110111111111011101010000001
10000000110101011100000010001
10000000000000001100000010001
1000000000000000110101001001
110000011101010111110111100111
11110111111101011101111010001
1111111111111111111111 111111
